W W W W W W W W W W W W W W W W
W P P P P P P P P P P P P P P E
W P W P W W W W W W W W W W W W
W W W P P P P P P P P P P P P W
W P W W W W W P P W W W W W W W
W P P P P P P P P P P P P P W W
W P W W W W W W P W W P P P W W
W P W W W W W P P P P P W P P W
W W W W P P P W W W W W W P W W
W P W P P W P P P P P P P P P W
W P P P W W P W P W P W P W P W
W W W W W W W W W W W W W W W W